***************
*...*.........*
*...*........**
*...*.......*.*
*...*...****..*
*....*.*......*
*.....*.......*
*.....*.......*
*.....*****...*
*....*.....*..*
*****.......*.*
*............**
*.............*
***************